1111111111111
1E00100C000C1
1000000111001
1P001100C00X1
1111111111111
