1111111
10C0P00
1E01001
1111111
