1111111
10C0P01
0E01001
1111111
