111111111111
100C0000001
111000000P01
1E0001001
111111111111
