11111111111
100C0000001
111000000P1
1E000100001
11111111111
