11111111111
1000000 001
1111P000001
100000000C1
100020E1111
11111111111
