11111111111
10000000001
1111P000001
100020000C1
100000E1111
11111111111
