1111111111111111111111111111111111
1P000X0C011110C000000000C001111001
1000000000X0000000001111000000X0C1
1000C1111000000000C0000000X0000001
1C00000000000C001111000C0000C00001
10X00C0000000000000C000000000000C1
1000000000000C0000001111000X000001
1000001111000X00000000C000000C0001
100C00000000000111100000000000X001
10000X000000C000000000000111100001
1C01111000000X000000C0000000C00001
1000000000000000000000000000000C01
10000C0000C0000001111000000X000001
1X000000111100X00000XC000000C000E1
1111111111111111111111111111111111
