1111111111
1P000C0001
1000000001
1111000001
1000000C01
1000000111
1C000C0001
1000110001
1C00000CE1
1111111111
