1111111111111111111111111111111111
1E0000000000X00C00000C0000000000X1
1000010100100000101001000000010101
1000010010101010001001000000010101
1P0000000C00C0000000000X00000000C1
1111111111111111111111111111111111
