11111111111
100C000001
111000000P1
1E000101
11111111111
